BOS	E	A
BKN	E	A
PHI	E	A
TOR	E	A
NYK	E	A
CHI	E	C
CLE	E	C
DET	E	C
IND	E	C
MIL	E	C
ATL	E	S
CHA	E	S
MIA	E	S
ORL	E	S
WAS	E	S
DEN	W	N
MIN	W	N
OKC	W	N
POR	W	N
UTA	W	N
GSW	W	P
LAC	W	P
LAL	W	P
PHX	W	P
SAC	W	P
DAL	W	S
HOU	W	S
MEM	W	S
NOP	W	S
SAS	W	S